R 1920 1080
NO ./bluestone.xpm
SO ./new.xpm
WE ./grito.xpm
EA ./night.xpm
S ./path_to_the_sprite_texture
F 220,100,0
C 225,30,0
111111111111
100011000001
100000000001
100100010001
100000000001
100000010001
111111010001
110011010001
100011010001
100011010001
110022220011
111111111111