 WE    ./azulejos_2.xpm
EA    ./azulejo.xpm
R    1920 1080
NO      ./mirador.xpm
SO    ./new.xpm
S ./violin.xpm
F 230,     180, 13
C 51, 247, 251
    1111111111111
 11100000111001
100020000000001
100000202220111
10010000E001
100000000001
111101111111
   111




