R 1920 1080
NO ./mirador.xpm
SO ./new.xpm
WE ./azulejos_2.xpm
EA ./azulejo.xpm
S ./violin.xpm
F 230, 180, 50
C 245, 3, 89
111111111111
100000111001
100000000001
100000220001
100000000001
100000000001
100000000001
100000011101
100220000011
100000000001
100100E00001
100000000001
111111111111