R 1920 1080
NO ./mirador.xpm
SO ./new.xpm
WE ./azulejos_2.xpm
EA ./azulejo.xpm
S ./violin.xpm
F 220,100,0
C 225,30,0
111111111111
100000111001
100000000001
100000000001
100000000021
1001100N0021
101110000001
100000011101
100000000011
100000011111
102000000201
111111111111